"","8","8.1","9","9.1","10","10.1","11","11.1","SUM"
"HLA-A*01:01",616,616,2643,2643,1035,1035,679,679,9946
"HLA-A*02:01",3152,3152,19521,19521,5800,5800,3068,3068,63082
"HLA-A*03:01",34,34,1004,1004,556,556,179,179,3546
"HLA-A*11:01",59,59,1257,1257,495,495,341,341,4304
"HLA-A*23:01",56,56,709,709,151,151,111,111,2054
"HLA-A*24:02",820,820,3686,3686,968,968,533,533,12014
"HLA-A*25:01",3,3,287,287,194,194,34,34,1036
"HLA-A*26:01",27,27,508,508,205,205,86,86,1652
"HLA-A*30:01",6,6,680,680,94,94,15,15,1590
"HLA-A*32:01",5,5,1801,1801,135,135,39,39,3960
"HLA-A*33:01",17,17,458,458,108,108,103,103,1372
"HLA-A*33:03",254,254,1156,1156,634,634,693,693,5474
"HLA-A*66:01",11,11,403,403,114,114,95,95,1246
"HLA-A*68:01",6,6,494,494,223,223,47,47,1540
"HLA-B*07:02",1041,1041,4473,4473,1569,1569,726,726,15618
"HLA-B*08:01",306,306,712,712,57,57,28,28,2206
"HLA-B*13:02",50,50,835,835,78,78,40,40,2006
"HLA-B*14:02",117,117,292,292,13,13,17,17,878
"HLA-B*15:01",64,64,518,518,152,152,14,14,1496
"HLA-B*15:02",3975,3975,14115,14115,2682,2682,1175,1175,43894
"HLA-B*18:01",520,520,1075,1075,207,207,77,77,3758
"HLA-B*27:05",48,48,1791,1791,887,887,580,580,6612
"HLA-B*27:09",68,68,1395,1395,464,464,406,406,4666
"HLA-B*35:01",90,90,518,518,154,154,81,81,1686
"HLA-B*35:02",282,282,2540,2540,364,364,238,238,6848
"HLA-B*35:03",24,24,255,255,57,57,29,29,730
"HLA-B*38:01",24,24,353,353,59,59,53,53,978
"HLA-B*39:01",74,74,298,298,28,28,24,24,848
"HLA-B*40:01",421,421,4143,4143,2537,2537,1746,1746,17694
"HLA-B*40:02",115,115,602,602,167,167,75,75,1918
"HLA-B*41:01",56,56,924,924,129,129,14,14,2246
"HLA-B*44:02",131,131,1499,1499,981,981,486,486,6194
"HLA-B*44:03",124,124,1081,1081,601,601,187,187,3986
"HLA-B*49:01",248,248,1187,1187,151,151,57,57,3286
"HLA-B*51:01",3389,3389,4610,4610,776,776,373,373,18296
"HLA-B*53:01",30,30,215,215,64,64,42,42,702
"HLA-B*57:01",113,113,643,643,367,367,229,229,2704
"HLA-B*58:01",48,48,403,403,188,188,109,109,1496
"HLA-C*03:04",172,172,3959,3959,183,183,26,26,8680
"HLA-C*04:01",122,122,578,578,117,117,72,72,1778
"HLA-C*05:01",709,709,4367,4367,674,674,193,193,11886
"HLA-C*07:01",35,35,651,651,53,53,32,32,1542
"HLA-C*08:02",53,53,293,293,58,58,16,16,840
"HLA-C*12:03",79,79,2014,2014,111,111,44,44,4496
